dsfs;dfjkhkjkhj

dsgsfgd
sdgsdg
sdgsdg

