azertyuiop
poiuytreza
julien
test
essai

