 
dsfsdf sdsf ds gdsg sdg 
sdg sdg sdg sdg sdgsd gdsgsdg
sdg sdgsdg sdgsd g
sdg sdg sdg sdg sdg 
sdg sdg sg sdg sdg dsg 
